#######################################################
>@....................................................#
#.....................................................#
#.....................................................+
#.....................................................#
#.....................................................#
#.....................................................#
#.....................................................+
#.....................................................#
#.....................................................#
#......##+###.........................................#
#......#....#.........................................#
#......#....#.........................................+
#......#....#.........................................#
#......######.........................................#
#.....................................................#
#######################################################
