#######################################################
∩@....................................................#
#.....................................................#
#...................................................../
#.....................................................#
#.....................................................#
#.....................................................#
#...................................................../
#.....................................................#
#.....................................................#
#......##+###.........................................#
#......#....#.........................................#
#......#.?..#........................................./
#......#....#.........................................#
#......######.........................................#
#.....................................................#
#######################################################
