#######################################################
>@....................................................#
#.....................................................#
#.....................................................+
#.....................................................#
#.....................................................#
#.....................................................#
#.....................................................+
#.....................................................#
#.....................................................#
#......o....o.........................................#
#.....................................................#
#.....................................................+
#.....................................................#
#......o....o.........................................#
#.....................................................#
#######################################################
