#######################################################
∩@....................................................#
#.....................................................#
#..............................................V......+
#.....................................................#
#..................................#####..............#
#......................................#..............#
#..................................#...#............../
#..................................#...#..............#
#..................................#...#..............#
#.....###/###......................#...#..............#
#.....#.....#......................#...############...#
#.....#.....#......................#.?...________...../
#.....#..?..#......................################...#
#.....#######.........................................#
#.....................................................#
#######################################################
