################################################################################################################
#..............................................................................................................#
#..............................................................................................................#
∩.......................................................................................................V......+
#..............................................................................................................#
#...........................................................................................#####..............#
#...............................................................................................#..............#
#...........................................................................................#...#............../
#...........................................................................................#...#..............#
#...........................................................................................#...#..............#
#.....#######/#######.......................................................................#...#..............#
#.....#.............#.......................................................................#...############...#
#@....#.............#.......................................................................#.?...________...../
#.....#.............#.......................................................................################...#
#.....#.............#..........................................................................................#
#.....#......|......#..........................................................................................#
#.....#.............#..........................................................................................#
#.....#.............#..........................................................................................#
#.....#.............#..........................................................................................#
#.....###############..........................................................................................#
#..............................................................................................................#
#..............................................................................................................#
#..............................................................................................................#
#..............................................................................................................#
#..............................................................................................................#
#..............................................................................................................#
#..............................................................................................................#
#..............................................................................................................#
#..............................................................................................................#
#..............................................................................................................#
#..............................................................................................................#
#..............................................................................................................#
#..............................................................................................................#
################################################################################################################
