##############################################################################
#............................................................................#
#............................................................................#
∩.....................................................................V......+
#............................................................................#
#.........................................................#####..............#
#.............................................................#..............#
#.........................................................#...#............../
#.........................................................#...#..............#
#.........................................................#...#..............#
#.....#######/#######..........#...#......................#...#..............#
#.....#.............#.....................................#...############...#
#.....#.............#............?........................#.?...________...../
#.....#.............#.....................................################...#
#.....#.............#..........#...#.........................................#
#.....#......|......#........................................................#
#.....#.............#........................................................#
#.....#.............#........................................................#
#.....#.............#........................................................#
#.....###############........................................................#
#............................................................................#
#............................................................................#
#............................................................................#
#............................................................................#
#............................................................................#
#............................................................................#
#............................................................................#
#............................................................................#
#............................................................................#
#............................................................................#
#............................................................................#
#............................................................................#
#@...........................................................................#
##############################################################################
