#######################################################
∩.....................................................#
#.....................................................#
#..............................................V......+
#.....................................................#
#..................................#####..............#
#......................................#..............#
#..................................#...#............../
#..................................#...#..............#
#..................................#...#..............#
#.....#######/#######..............#...#..............#
#.....#.............#..............#...############...#
#.....#......@......#..............#.?...________...../
#.....#.............#..............################...#
#.....#.............#.................................#
#.....#......|......#.................................#
#.....#.............#.................................#
#.....#.............#.................................#
#.....#.............#.................................#
#.....###############.................................#
#.....................................................#
#.....................................................#
#######################################################
